21;22;
#####################
##.................##
##.#.#####.#####.#.##
##.#......p......#.##
##.#.#####.#####.#.##
#..#.....#.#.....#..#
#.######.#.#.######.#
#...s#.........#s...#
#.##...#.#.#.#...##.#
#.####.#.#.#.#.####.#
#......#.#.#.#......#
##.#####.....#####.##
##...###.#.#.###...##
#..#.....#.#.....#..#
#.######.#.#.######.#
#....#...#.#...#....#
##.#...###.###...#.##
##.###.###.###.###.##
##.s.#.........#.s.##
##.#.#.###y###.#.#.##
##.....##rgb##..c..##
#####################