20;20
####################
####.....###########
#.s..###...........#
##.#.....#.#######.#
#..#######.#......s#
#.##.....#...#####.#
#....#.#...#.......#
###.##.#####.####.##
#....#.#...........#
#.#.##.#.## ###.##.#
#...#...p#yrgb#.#..#
#.#.#.##.######.#.##
#.#.#..#...#..#.#..#
#.#.##.#.#.c.##.##.#
#.#....#.###.......#
#....#.......#####.#
##.###.#.#.##......#
#.s..#.#.#....####.#
#.#....#....#...s..#
####################