20;20
####################
#........##.......v#
#.##.###.##.###.##.#
#.##.###.##.###.##.#
#h..s....c.....s...#
#.##.#.######.#.##.#
#....#...##...#....#
#.##.###.##.###.##.#
#.##.#........#.##.#
#.##.#.##  ##.#.##.#
#......#rgby#......#
#.##.#.######.#.##.#
#.##.#........#.##.#
#......######......#
#.##.#...##...#.##.#
#.##.#.#.##.#.#.##.#
#...s#....p...#s...#
#.######.##.######.#
#........c.........#
####################