20;20
####################
#s.........c.......#
#.##.##.######.#.#.#
#.#...#.....#..#.#.#
#.#.#.#..##.#..#...#
#.#.#.#..#..#....#.#
#.#......#..#..#.#.#
#...####.........#.#
#.#.....#######..#.#
#.#.###.# rgby#....#
#.#.....# #####.##.#
#.##.##.#...##...#.#
#.#...#...#..p.#.#.#
#...#.########.#.#.#
#.###..........#...#
#...#.#.##.#####.#.#
#.#...#.#........#.#
#.##.##.#.#.##.#.#.#
#.s.....#......#...#
####################