20;20
####################
#..p.............c.#
#.####.######.####.#
#..................#
#.####.######.####.#
#....#..####..#....#
#.##.#.######.#.####
#.##.#..####..#.####
#..s...............#
#.###.########.###.#
#.###..........###.#
#.....#.####.#.....#
#.##.##.#rg#.##.##.#
#.......#by .......#
####.#..####..#.####
####.#.######.#.####
#....#........#....#
#.####.######.####.#
#...............s..#
####################