20;20
####################
#.s................#
#.#####.######.##.##
#.#......#.....#...#
#.#.####...###.#.#.#
#.#.#....#...#.#.#.#
#.#...##.###.#...#.#
#...#..#.......#.#.#
#.###..#.#y###.#.#.#
#......#.#rgb#.#.s.#
#.######.#####.#.#.#
#.......p.#...#....#
#.#.###.....#.#.#..#
#.#.#...#.#.#...#..#
#.#...#.#.#.#.#.#..#
#s..###.#.#.#...#..#
#.#.......#..#.....#
#.######.###.#####.#
#.............c....#
####################